111111111111111111111111
1E0000000000100C00000C01
100011110010000110100101
1P1100001010101000100101
101001001010101000100101
1000010010101010C0100101
100001001010101000100101
1000001010101010C0100101
100001000C00C00000000001
111111111111111111111111