111111111111
1P000E000C01
111111111111