1111111111111
1000000000001
10C0111000C01
10C1111000011
10P10000000C1
1000001000111
1C00101000101
1010100111E01
101C0000C0001
1111111111111